+-------------+
|S****    *   |
|*   *  ***   |
|    ****     |
|       ***   |
|       F     |
+-------------+