+----------------------------------------+
|*                                     F |
|*      ***** *********      *           |
|****   *   * *       *      *           |
|   *   *   * *       ********           |
| ***   *   * *       *  *               |
| *     *   * *       *  *               |
| *******   * *       *                  |
|   *    **** *       *   *         *****|
|   *    *    *       *   *             *|
|   *    ******       ********          *|
|   *                        *          *|
|   S                 *******************|
+----------------------------------------+